00000000000000000000
02211111111111111220
02111111111111111120
03333333333333333330
03333333333333333330
03333333333333333330
03333333333333333330
03333333333333333330
03333333333333333330
03333333333333333330
03333333333333333330
03333333333333333330
03333333333333333330
03333333333333333330
03333333333333333330
03333333333333333330
03333333333333333330
02111111111111111120
02211111111111111220
00000000000000000000